NO ./sprites/north_wall.xpm
SO ./sprites/south_wall.xpm
WE ./sprites/west_wall.xpm
EA ./sprites/east_wall.xpm

F 0,0,0
C 255,255,255

111111111111111111111
101000001000000000001
101010101011111110001
100010100010000010001
111110101111101011101
100000101000101000001
101111101011101111111
101000001010100000101
101011111010111110101
101010000000100010101
101110000000101010101
100000000000001010001
111111101011111011101
100000111011110010001
101110000000001110111
1010000    0000010101
10100000     00010101
10100000   0000010001
101000000000000001101
1W1000001000000000001
111111111111111111111



