      F 3,92,92
 	    			C	2,		                   			  255	, 	0

    		NO ./sprites/north_wall.xpm
SO ./sprites/south_wall.xpm
   		WE ./sprites/west_wall.xpm
 EA ./sprites/east_wall.xpm



 11111111111
100000000S1
11111111111
