      F 3,92,92
 	    			C	2		                   			  255	, 	0

SO 	./assets/south_texture.xpm
     NO dsf	ds.xpm
WE ./assets/west_texture.xpm
	  EA 	./assets/east_texture.xpm



 11111111111
100000000S1
11111111111
