NO ./sprites/north_wall.xpm
SO ./sprites/south_wall.xpm
WE ./sprites/west_wall.xpm
EA ./sprites/east_wall.xpm
F 125,200,10
C 140,125,10

11111111
100S0001
10010001
10010101
101N0001
11111111
11111111
